R  800 600

NO  ./textures/eagle.xpm
SO ./textures/greystone.xpm
EA ./textures/red.xpm
WE ./textures/purplestone.xpm
S ./textures/tree_snow.xpm
S1 ./textures/coeur.xpm

C 135,206,250

F 0,100,0
 
                                  111
        1111111111111111111111111 101
        1000000000110000000000001 111
        1011000001110000002000001
        1001000000000000000011111
  11111111101100000000000000001
  10000000001100000100000000001
  100000000011000000000020000011111
  100000000000000022222222222220011
  10E000022222222222222222222220011
  100000022222222222222222001111111
  100000000000000000000000001111111
  100000000000000000000000001111111
  100000000000000000000000001111111
  100000000000000000000000001111111
  100000000000000000000000001111111
  100000000000000000000000001111111 
  100000000011000001000020001
  100000000011000001000000001111111
  111111111111111111111111111111111
       
