R 300 300
NO ./textures/b2.xpm

SO ./textures/b2.xpm
WE ./textures/b2.xpm
EA ./textures/b2.xpm
S1 ./textures/mouton.xpm
S2 ./textures/coeur.xpm


F 0,100,0

C 135,206,250
           1111111111111111111111111
           1000002003110000002000031
           1011002021110000002302001
           1001000000000000000222001
   11111111101100000111000022000001
   130000000011000001110111110111111
   11110111111111011100000012021
   11110111111111011101010012021
   11000000110101011100000010001
   10002000000000001100000010001
   13000000000000001101010010001
   11000001110101011111011110N0111
   11110111 1113101 101111010301
   11111111 1111111 111111111111