R 1200 600
NO ./textures/NO.xpm
SO ./textures/SO.xpm
WE ./textures/WE.xpm
EA ./textures/EA.xpm
S1 ./textures/tonneau.xpm
S2 ./textures/coeur.xpm

F 181,181,181
C 135,206,250

1111111111111111111
1000000020000000031
1000000200001000001
1000000000201000001
1000000000201000001
1000000000201000001
1000000000201000001
1000000000201000001
1000000000201000001
1000000000201000001
1000000000000000001
1000000000201000001
1000000000201000001
1000000000201000001
1000000000201000001
1000000000000000001
1000000000201000001
100S000000201000001
1000000000201000001
1000000000201000001
1000000000201000001
1000000000000000001
1111111111111111111