R 600 600
NO ./textures/NO.xpm
SO ./textures/silex.xpm
WE ./textures/silex.xpm
EA ./textures/silex.xpm
S ./textures/coeur.xpm

F 181,181,181
C 135,206,250

1111111111111111111
100E0000020000000010
1002000000001000001
1000000000001000001
1000000000001000001
1111111111111111111