R  900 900

NO  ./textures/planche1.xpm
SO ./textures/planche1.xpm
EA ./textures/planche2.xpm
WE ./textures/planche2.xpm
S  ./textures/nazgul.xpm
S1 ./textures/coeur.xpm
S2 ./textures/ring.xpm
W  ./textures/spear.xpm

C 126,122,122

F 0,0,0

111111111111111111111111111111111111
1E0000000000000000000000000000000031
111111112000200000000000000000000001
100010001000000000000300000000000001
100000000000000000111000000000000001
120202020200200000001000000000000001
100000000000000000011000011300000001
100000000000000000010000011500000001
120000000000200000100100011100000001
100000000000000010000010000000000001
110000000000000010000000000002000001
130100000000001100000000000000020001
100000000001113000000010000200000001
100011000200002000001100000000200001
100001020002000000000000002020000001
100001000000002001000002000000120221
100050000200200000000000000010000211
102002000000000110000200000000102401
100000000002000030000000000000001001
111111111111111111111111111111111111



