C 135,206,255


R 800 800
NO ./textures/planche1.xpm
SO ./textures/planche2.xpm
WE ./textures/planche3.xpm
EA ./textures/roche1.xpm

S ./textures/gandalf.xpm

F    0,181,181

1111111111111111111
1S00000000022112211
1020000000001001211
1000111110001000001
1000000000100000001
1000000000000000101
1000011100100000001
1000000000100000001
1000000000100000001
1000000000100000001
1000000000000000001
1000000000100000001
1000000001000000001
1000000000100000001
1000000000010000001
1000000000000000001
1000000000010000001
1000000000010000001
1000000000010000001
1000111100010000001
1000000000001000001
1000000000000000001
1111111111111111111

