R 600 600
NO ./textures/NO.xpm
SO ./textures/SO.xpm
WE ./textures/WE.xpm
EA ./textures/EA.xpm
S1 ./textures/tonneau.xpm
S2 ./textures/coeur.xpm

F 181,181,181
C 135,206,250



1111111111111111111
1000030020000000011
1000000200001000001
1000211111201000001
1000200000201000001
1000200000201000001
1002001110201000001
1000200000201000001
1000200000201000001
1000200000201000001
1000200000000000001
1000200000201000001
1000200000201000001
1000200000201000001
1000233330201000001
1000000000000000001
1000000000201000001
100S000000201000001
1000000000201000001
1000111100201000001
1000000000201000001
1000000000000000001
1111111111111111111