R 600 600
NO ./textures/NO.xpm
SO ./textures/SO.xpm
WE ./textures/WE.xpm
EA ./textures/EA.xpm
S1 ./textures/tonneau.xpm
S2 ./textures/coeur.xpm

F 181,181,181
C 135,206,255
1111111111111111111
1000000000000030011
1000000000001000001
1000111110001000001
1000000000100000001
1000000000100000001
1000011100100000001
1000000000100000001
1000000000100000001
1000000000100000001
1000000000000000001
1000000000100000001
1000000001000000001
1000000000100000001
1000200000010000001
1000000000000000001
1000000000010000001
100S000000010000001
1000000000010000001
1000111100010000001
1000000000201000001
1000000000000000001
1111111111111111111