R 1200 900

NO ./textures/b1.xpm
SO ./textures/b1.xpm
WE ./textures/b1.xpm
EA ./textures/b1.xpm
S ./textures/mouton.xpm
S1 ./textures/coeur.xpm
S2 ./textures/towin.xpm
W ./textures/spear.xpm

F 0,100,0
C 135,206,250



           1111111111111111111111111
           1004002003110000002000031
           1011002021110000002302001
           1001000000000000002222001
   111111111011000001110000205000001
   130000000011000001110111114111111
   11110111111111011100000012021
   11110111111111011101010012021
   11000000110101011100000010001
   10002000000000001100000010001
   13000000000000001101010010001
   11000001110101011111011110N0111
   11110111 1113101 101111010301
   11111111 1111111 111111111111


