R  2147483647 2147483647
C 255,20,30
F  000,000,00

NO      ./textures/eagle.xpm
SO ./textures/greystone.xpm
EA ./textures/red.xpm
WE ./textures/purplestone.xpm

S1 ./textures/pilier.xpm

111111111111111111111111111111
100000000010100000001000100001
101000101110101010101010111101
101010100010100200101000000011
111010011010101011111011101111
101000100000100000000000100011
101111101010101110201110101101
10100000100E000010001010000001
101010101100100200201010101011
101002001000001000020010000201
121110111010101110121110101111
101010100010020010000000001001
101010111110002011111020101011
101000001010000200000000000201
101011101010111010101011102011
101012000000000000020000000011
101110111010100010101010110001
100010000200121000101010100221
101011001011021110120100101011
100000001010001010101010000221
101011111111101011121010101011
100010002000000000001000001001
101110001012201010111011100011
101000000010001010000000000201
100110111211111001100010011011
101200000200100200101010001011
101010111011101010111101101111
100000000200101000001000001011
101001101011111011101011100001
101000000000100202001010020201
101111001010110010001111011011
100002220010001000000010100201
101101001111101010111110011011
100200100020020010000010000201
111011100111101101101110111111
100002101000100000000010000011
101010101010111011100010101111
100010100000100010001000100001
101000110111101110101110111001
100010201000001000100000002201
101010101100022010101011001001
100200100010100000020000001001
102011102010110010101012002011
100000100010001010022000101001
101110001011100010201010110111
100000101010022000001010000011
101110111010100110000011101001
100010000010101010101010100011
101110001100111011100010001001
111111111111111111111111111111