R 1200 1200
NO ./textures/silex.xpm

SO ./textures/silex.xpm
WE ./textures/silex.xpm
EA ./textures/silex.xpm
S ./textures/tonneau.xpm
S1 ./textures/coeur.xpm


F 0,100,0

C 135,206,250
1111111111111111111111111111111111111111111111111111111111111111111111111111111111111111111111111111
1N00000300000000000000001000000000000000000000222222000000000000001010000000000000000010001000000001
1011001011101111101011101010101010001110101111101010001001101111111011111110101011111111011111111101
1000001000000000100000000000100000001010101010001000000000000010001000100000001000000000000000001001
1101101010100001100101111110111110001000110010111110100111001001101001101110011011101010101110101011
1010100000000010000000001000000000000010000000000000101010000000100000100000001000001000100000100001
1000101000100010111001011011111000101110011110011011101010011010001011111001101010101010111010001111
1010000000001000001000001010100000000010100000000000000010001000000000000000100000101010101000000011
1100111010110011111011101010111000001110111001111110101110100011110111101100100010101010101010111011
1000101000001010001000000010000000100000000000000000100010100000000010100010000010000000100000001011
1011100011001010111001100010110110111010011010101000101010111110001110101110100010101010100100101111
1000000000001000100010000000000000100010100000000010000000100000001010000000000010001010100010000011
1010101010101110100111101110011111100000011010101110101010101000101010111000100011101100111110001011
1000000000001000000000001010000010000010101000000000000010001000001000100010000010001010001010001001
1010100110011011111111110011101010111010101010101110111010101110001010101011101110111011101001100111
1000100000100000100010000000001000001000001000000010101010001000100010101000100010001010000010001001
1000101010101110010010110010101001011111101010110100101010111100101011110111101000101011011101001011
1000101010101000000010000010000000000010101000000010001000000010100010100000101010100000101000100011
1110101110100101100101101011011010101010101110100000111110111011101110100010011010001110001010011011
1010100010101000100010100000000010100010001010000000101010001010000010000010100000000000100010100001
1010101000101011111010011010111110101111111000111011101010001010001010101010100111101111111010101011
1000100000000000001010101000001000000000001000000000101000000010100010100010100000000000000000001011
1011101111111010001110101110100011111000101011101010111001101010101000100000101110111111101010110111
1000100000000010001000100000000000000000000010000000100000001000000000100000100000000000100000000011
1010101110101010101111111010101011101010101110101111001101111010101010101011101110101110101110001011
1000000010100000101000100000001000001010000000101010000000100000001000000000000000000000100000101011
1010111111100001111010101111101010100010101010101001011111101010111110101110111111111110001010011011
1000000000101010000000100000101010100010100000001000101000000010001010001010000010001000100000001011
1010101111101111101010110010101110101000101010100010100010111010111000101010101000101010110110101011
1000001000101010000000000000000000101000100000000010000000000010000010100000100000000000000010000001
1000111111101010001110111111110011101010111000111010101111111010101000111010001110101010101010101011
1000100010100010000000000000000000000000000010100000100000000010000000001010000000001000100010001001
1011101010001001101011101010100110111110011010111110111011101011101110101011101010101110111111111001
1010000000101000000000001000000000000000100010001010000000101000100000000000001010000010101010000001
1010101111011110100110001101111111100010001110111010100100101010001010011010111010101000101011111011
1000001000001010100010001000000000000010100000000010000010000000001000001000000000100010100010001001
1001111111100010101000101100111110101010111010100110101010001110101010101010101010111110101110101111
1000000000100000001010000000001000000010000000000010000010000010001000000010001000100000001000001001
1010111011001011100000101110101010101010101011101011101101101111101001111010111001101011100011111011
1000101000001010001010001010001010000010100010000010000000000010001010001000101000101000000000000001
1011101010101000001110111011001010001110111011001001111110101011110110001001000010001011101010111011
1010000000101000101000000000000000000000000000000010001000000010100010000000001000000000001010000001
1011101111101010101001010110101011101010011110100001111010001110101000101101110110101010111011011001
1010000010000000000010001000100000101000100010100000000010000000001000000000001010000000001000100001
1010000100001010111010011010101110111010101110111001001010101010100011110110001010101111101010011011
1000001010001000001000001010000010000000000000101010000000101000100000000000000010000000001010001001
1001001011001010101000001110101000110110001011101111101100001011111111101010101110101111111111101011
1000100000001010000000001000101010001010001000101000001000101000101000001010001000001000000010001001
1110100111111110111110101011101001101001001110101111111111001111101010100111101110001011000010101101
1000000010000000101000100010101010000000000010000000000000100000000000001010000000000010001000000001
1011101010111100101110101000011110111110101110101010011110111011101111111001110010001110101010111011
1000000010100000000010000000000000100000000010000000001000000000000000001010100000000010000000101001
1101101000100110111010101010011110101101101000111100011010011010101000101110101010111011101111100101
1000100000101000000000100000001000101000001010001000101010000000100010100010101000001000000000000001
1010100010101111101111101000111111111010001010101110101000001000110011100110111011101011101110100001
1010100000100000001000101010000000100000100000000000000010000000001010001010001000000000000000001001
1001101100000011111001101100111010011011101111101110001101110010100010101010101010000111101010011011
1010001000001000100000000000001000000000101000000010100000100000001000000000000000100000001010000001
1001111010001111010100101010101010111010111100101010100000111110100010001010111011011111001011101101
1010000000000000100000000010100000100010001000100010000000000000000010000010101000100000100000000001
1010101010011010100010101111101111101010101010000010001110101010001011101001101010011011111010111011
1000000000000000000010000000000000001000000010101000000000000000101000100000101000001000100000000001
1101011010101010001010000001111011101010101011100010101011101011100010101000001011111100111010111011
1010000000001010001000000000000000101010000010001010000000000000001010101000000000000000000000100001
1010111110101110001010101010001111001010101011101111101011101010101010101011101110101100111011011011
1000000000100000001000001000000000101000000000100000100000101000001010100010000000101000000000100001
1010100110111011101010100111101111000011101010111101101110100000001011101110110011111010011010111011
1000000000000000101000101010000010000010100000100000001000000010000010001000000000000010001000001011
1010100010000110001011100010101010101110101001101010101010100110101110101010111001101010100010100111
1010101010000010001000001000001000001000000010001000001000001000001000001000100010001000001000001011
1001101010001011100101001110101010001010111010100111101110101101110010010101100001011010101010101001
1000101010000010000000000000001010001010100000100000000000100000100000101000100000000000000010000001
1010100011010011111010111101010010001010101111111010101011101111101010101110111010111010101110101101
1010001000100000000000100000000010000000100000000000100000100010101010000000100010000000001000000011
1010101000011111101111101011111110111011101011100000000011101110111100111010111111101010101111100011
1000000010100000100000100010001000000000000000001010100000001000000010001010000000001000000000001011
1110100111111100011010101100111110011000001010101010101010101011111011111010101010101110111110111011
1000000000000000000000000000100010000000001010000000100010100000000010000000000000000010001000100001
1010100110101001111001001001100010110000101111110011111010101011111110001011101010101011111011110001
1000000000001000100000000000101010100000000000100010100000100000100000000000000000001000101010000001
1111011010001011101110001010101110011010111010101000101010111010100000111000111111101010101010100011
1000101000000010000000001010000000000000000010000000001000000000001000000010001000000000000000101001
1011100010110011101110001001110111111010101010101011101000110010101011101011101110101011001010111011
1000000000000000100000000000100000000000000000000010100000100000100000101000101000000000001000001011
1000100010111011110011000110110110101110101011111000000010101010101011101001101010001111101101101011
1000000010001000000000000000001000000010001000000000101010000010000010000000001010100000001000101001
1110111010111010100111011111001011001101111011101010101010101100101110111110101111101010110011101011
1010001000100010100000101010000010100010001000100000001010000010001010001000000000100000000010100001
1010111010111111101011101010100000001110000010100010011110101011111001101100101010101110101010001001
1000000000001000100000100010100000001000000010001000100000100000001010000000000000101000000000100001
1001010011011101001000101010000011101010110010101010111010100010101011101110111010011000101010101111
1000000000000000100000000000000000000000100000001010000000101010001000101000100000101000001000001001
1011010111100000111011101001100111101110101010111100110110101010001010101010001110100110101010101111
1010000000000010001000101000100010000000101000101000000000001000100000000000000010001000101000000001
1000111010011110010011011010110010101101101010001100101101000011101010110010111110101010111011101011
1010000000100010000010000010000010100000000000001000001010001000000000101010000000001010001000101011
1010101010111011101010111111101110101111100010101010111010101000101110101111111110101010101011001111
1000101000001000000000000000100000100000000000001010100010001010000000100010000000100000001000001001
1100111010001110101011100111100010001010100000101010000110101100101110101110111011101111011000000311
1111111111111111111111111111111111111111111111111111111111111111111111111111111111111111111111111111